
         #############
       ##            ##
      #                #
      #                # 
 #####        #############
#     #      #        #  # #
#     #      #          ## #
#             ##### #######
#                      #
#     #                #
#     #                #
 ######                #
      #       ##       #
      #      #  #      #
      #      #  #      #
       ######    ######