 #######
 #  #  #####
##  #  #OOO###
#  X#  #OOO  #
# X #XX OOO  #
#  X#  #OOO O#
#   # X########
##X       X X #
##  #  XX #   #
 ######  ##XXP#
      #      ##
      ########