    #### ####
   ###########
   # O     O #
    # # # # #
     ## # ##
     #  #  #
     #  #  #
     #  #  #
     #  #  #
     #  #  #
     #  #  #
     #  #  #
     #  #  #
 ###### # ######
#       #       #
#  X    P    X  #
#     #####     #
 #####     #####