############
# O        #
# P   #### #
#          #
#####      #
# O #     
#   ##### ##
#   #      #
#       XX #
#   #   #  #
############