###############################################################################
#                                #            #                               #
#                               # #          # #                              #
#                              #  #          #  #                             #
#                             #  ### ###### ###  #                            #
#                              ## ####    #### ##                             #
#                              #     ######     #                             #
#                              #  ##        ##  #                             #
######                         #  #O#  ##  # #  #                             #
#    #                          #              #                              #
# ## #                    ###### #  ########  # ######                        #
#O## #            ######## #      # ##    ## #      # #######                 #
# ###         ####          ######  ########  ######         ####             #
# ### ###   ##                  #  #        #  #                 ##           #
#       #  #                ####    #      #    ####               #          #
#O#####    #           #####         #    #         ####           #          #
###############################################################################