#####################
#         O  #      #   #
# #### #     #  # # #  # #
# # ## #######  # # #  ####
# # ##    ####### # #    #
# #     #       # # #
# ##### #### #### # #   ##
# #     ####      # #  # ##
# # #          ## # #     #
# # ## ####### ## # #  ###
# #             # # #
# ### ##### ## ## # #   ##
# # # #   #       # #  # ##
# # #   #   ### # # #   ##
# # #########   # # #  ####
# #             # # #
# # # ######## ## # #   ##
# # #           # # #  ###
# # # ####### #   # #   ##
# # # #   X   ### # #   ## 
# #   #   P       # #
# ################# #  ### 
#                   #  #  #
#####################  #  #
   # ## ##### ## #      ###
 