###################################################################################################
#  ##   ##    #   #      #  #  #   #    ###  # #  # # # # #  ### # # #  # # #  #   ##  #   #  #  #
### #      #  ### # #     # #      #  # # # # #   #  ##  #  # ##      # #  #  #     #       #  # ##
#  # # # #  #        # # # #  #     # #  #  ## #    # # #    # #   # # # ##   #       ##  # # #   #
## #      ## ##   # #    ##  #  #  # ##   # #  #   #  ##  # ###  # # #  ##       ##  #      #  #  #
#     # # # # #         ##        #   #    #       #  # #  # # #   # #   # ##   #    #    #       #
##   #  # #   #  #  # #     ##   ################################  ### # #  # # ## #   #  #     # #
#     # #     #   # # #  # # #   #                              ##### #  #       # ## #  #  # # ###
## #  ## # ###      #  #  ##  # ##                              # # # #    #  #### ##   #   #     #
#   # #  #  #          # #  # # ##                              #  #  #    #  #    # #  #   # # # #
# #  # #        ##    # #  # # ###                              #     #    #  #        #     #    #
## #         #       # # ## # #  #                              # # #  ## ##  ##  #  # #  #  #    #
# #    # # #     # ###   #  # #  #                              #  ###     #  #   #    #    # #   #
# # # # # # # #  #   #  ##   #  ##                              #   #    ##  # # # ## #  # #  # # #
# #  ##  #  #    # # #   ###  # ##                              ## #    #  ## # #  ##  #    ##    #
##     ##   # # # # #  ##       ##                              ##    #    # # # # ## #      #  ###
# #          #     # # #      #  #                              ##   #   #   # # #    #  ## #   # #
#  #  # #     #  #  #         # ##                              # # #   #  # #  # # ## #  # # #   #
# #      ## #    #     # #  #  # #                              ## ##   #    #  #  #   # #  ##  # #
# #     #   # # # # ### #  #   ###                              # ## #  ##  # #   # #     # # #   #
##  # # #   #         #  # #  # ##                              ###   #  #   # # # ## #    # #   ##
##  #    #      # #   ## # #   ###                              # # # #  #  #  #   #    # # #    ##
#  # # # #  # # #    ## # # ## # #                              # # # # # # #     #    # #  ##  # #
#   # # #  #  # #  #    #   #    #                              ## # #    #  #      # # # # #    ##
#  #   #   # #  #       # #  #   ################################   #   #  #  #    #   #          #
# #  # # #  # #   #     ##  # #        # # ##  #  #  # #   ## #    # #  ##  #  ##  #  #   #    # ##
## # # #   #   #   ## #    # ##  # #    #  # ##   #  ##  #   #      # ##     ## #  #  # #    #  # #
#     #   ## #   #   ##  # #  #  #        #  # #  #      #  #       ##    #  #      # #  #        #
#  ### #  #   #  # # # #   #  #  # #  #     #    #   #   ##       # #   ####   # #    # #         #
### # #     # #   # # # # #  #    # #   # ## # # # #      # #          # ##  ## #    #  #    # # #
#O    ## #   # # #   # #  #    #   #  #  ##  # # #    #      #        #    # ##    #  #    #  #  ##
###################################################################################################
