     ##################       
     #                  ###    
    #                      #   
   #     #######     ###    #  
 ##    ##########   #####    # 
#                 #        # #
#             #    ##     #  #
 #  ##        # ## ###    #  # 
  #   ######              # #  
   #    # # ############## #   
    #    # # # ## ### # ## #  
     ##    ###############  #  
       ###                   # 
          ####               # 
              ###############  